0 0 0 0 0 0 0 0 0 0 0 0 0 0 0 0 0 0 < 4 4 4 4 4 4 4 4 4 4 4 4 4 4 4 4 4 4 4 4 4 4 4 4 4 4 4 4 4 4 4 4 4 4 4 4 4
3 3 3 3 3 3 3 3 3 3 3 3 9 0 0 0 0 0 J 5 5 5 5 5 5 5 5 5 5 5 5 5 5 5 5 5 5 5 5 5 5 5 5 5 5 5 5 5 5 5 5 5 5 5 4 4
4 4 5 5 5 5 5 5 5 5 5 4 B ? 9 0 0 0 0 0 0 0 0 0 0 0 0 0 0 0 0 0 0 0 0 0 0 0 0 0 0 0 0 0 0 0 0 0 0 0 0 0 0 0 7 4
4 : 0 0 0 0 0 0 0 0 0 5 4 4 B 9 0 0 0 0 0 0 0 0 0 0 0 0 0 0 0 0 0 0 0 0 0 2 0 0 0 0 0 2 0 0 0 0 0 0 0 0 0 0 7 4
4 : 0 0 0 0 0 0 0 0 0 0 5 4 4 B 9 0 0 0 0 1 0 H 0 H 0 H 0 1 0 0 0 0 I 0 2 0 2 2 2 2 2 0 2 2 0 0 0 0 0 0 G 0 7 4
4 : 0 2 I 0 0 F 0 0 G 0 0 5 4 4 B 3 3 3 3 3 3 3 3 3 3 3 3 3 3 3 3 3 3 3 3 E 3 3 3 3 3 C 3 3 3 3 9 0 0 6 3 3 A 4
4 : K 2 6 3 3 3 3 3 9 0 0 0 5 4 4 4 4 4 4 4 4 4 4 4 4 4 4 4 4 4 4 4 4 4 4 4 4 4 4 4 4 4 4 4 4 4 : 0 0 7 4 4 4 4
4 : K 2 7 4 4 4 4 4 B 9 0 0 0 5 5 5 5 5 5 5 5 5 5 5 5 5 5 5 5 5 5 5 5 5 5 5 5 5 5 5 5 5 4 4 4 4 : 0 J 7 4 4 4 4
4 ; 0 2 8 5 4 4 4 4 4 B 9 0 0 0 0 0 0 0 0 0 0 0 0 0 0 0 0 0 0 0 0 0 0 0 0 0 0 0 0 2 0 0 5 5 4 4 : 0 J 7 4 4 4 4
: 0 0 0 0 0 5 4 4 4 4 4 B 9 0 0 0 0 0 0 0 0 0 0 0 0 0 0 0 0 0 0 0 0 0 0 2 0 0 0 2 0 2 0 0 0 5 5 ; 0 0 8 5 5 5 4
: 0 0 0 0 0 0 5 4 4 4 4 4 B 9 0 I 0 0 0 1 0 H G 0 0 H 0 H 0 0 H 1 0 2 2 0 2 2 2 0 F 0 0 0 0 0 0 0 0 0 0 0 0 0 7
: I 2 2 2 0 0 0 5 4 5 5 4 4 B ? 3 3 E 3 3 3 3 3 3 3 3 3 3 3 3 3 3 3 3 3 C 3 3 3 3 3 3 9 0 0 0 2 0 0 0 0 0 0 0 7
B 3 3 3 9 0 0 0 0 5 0 0 5 5 5 5 5 5 5 5 5 5 5 5 5 5 5 5 5 5 5 5 5 5 5 5 5 5 5 4 4 4 4 B ? 9 2 0 2 2 2 1 0 H G 7
4 4 4 4 B 9 0 0 0 0 0 0 0 0 0 0 0 0 0 0 0 0 0 0 0 0 0 2 0 0 0 0 2 0 0 0 0 0 0 5 4 4 4 4 4 B 3 E 3 3 3 3 3 3 3 A
4 4 4 4 4 B 9 0 0 0 0 0 0 0 0 0 0 0 0 0 0 0 0 0 0 0 2 0 2 0 0 2 0 2 0 0 0 0 0 0 5 5 5 5 5 5 4 4 4 4 4 4 4 4 4 4
4 4 4 4 4 4 B ? 9 C 6 9 0 0 H 0 0 H 0 0 0 1 0 0 G 0 0 F 0 0 0 0 F 2 2 2 2 I 0 0 0 0 0 0 0 0 5 5 5 5 5 5 5 5 4 4
4 5 5 5 5 5 5 5 B 3 A B 3 3 3 3 3 3 3 3 3 3 3 3 3 3 3 3 3 3 3 3 3 3 3 3 3 3 9 0 0 0 0 0 0 0 0 0 0 0 0 0 0 0 7 4
: 0 0 0 0 0 0 0 0 0 0 0 0 0 0 0 0 0 0 0 0 0 0 2 0 0 0 0 0 0 0 0 0 0 0 0 0 0 B 9 2 2 2 2 I 0 0 0 0 0 0 G 0 0 7 4
: 0 0 0 0 0 0 0 0 0 0 0 0 0 0 0 0 0 0 0 0 0 2 0 2 0 0 0 0 0 0 0 0 0 2 0 0 0 0 B 3 3 3 3 3 3 0 0 H 0 6 9 2 J 7 4
: K 2 1 0 0 H 0 0 H G 6 3 3 3 3 E 3 3 3 9 0 0 F 0 0 0 0 0 0 I 0 0 2 0 2 0 G 0 0 0 0 0 0 0 0 3 3 3 3 A ; 2 0 7 4
: 0 2 6 3 3 3 3 3 3 @ A 5 5 5 5 5 5 4 4 B ? 3 3 3 3 3 3 E 3 3 3 3 3 C 3 3 3 9 0 H 0 6 9 2 2 2 H 0 0 0 H 2 0 7 4
: 2 0 7 4 4 5 5 5 5 5 5 0 0 0 0 0 0 5 5 5 5 5 5 5 5 5 5 5 5 5 5 5 5 5 5 5 5 B ? 3 3 A B 3 3 3 3 3 3 3 3 3 3 A 4
: 2 J 8 5 5 0 0 0 0 0 0 0 0 0 0 0 0 0 0 2 G 2 2 2 2 2 2 2 0 0 0 0 0 0 0 0 0 0 0 0 5 5 5 5 5 5 5 5 5 5 5 5 5 5 5
: 2 0 0 0 0 0 0 0 0 0 0 0 0 2 2 0 0 0 0 < = = = = = = = > 0 0 0 2 2 2 0 0 0 2 0 0 0 0 2 0 0 0 0 0 0 0 0 0 0 0 0
B 9 0 0 0 0 0 0 0 0 0 0 0 0 6 9 0 0 0 0 0 0 0 0 0 0 0 0 0 0 0 0 6 3 3 9 G 2 0 2 0 0 2 0 2 0 0 0 0 0 0 0 0 0 0 0
4 B 9 0 H I G H F H 0 0 0 6 A B 9 0 0 1 2 2 2 2 2 2 H 0 0 H 0 6 A 4 4 B ? 3 E 3 9 0 0 F 0 0 2 2 2 2 2 2 0 0 0 0
4 4 B ? 3 3 3 3 3 3 3 3 3 A 4 4 B 3 3 3 3 3 3 3 3 3 3 3 3 3 3 A 4 4 4 4 4 4 4 4 B 3 3 3 3 3 3 3 3 3 3 3 3 3 3 3
