4 0 0 0 0 5 5 5 5 5 5 5 4 4 4 4 4 4 4 4 4 4 4 4 4 4 4 5 5 5 5 5 5 5 5 5 5 5 5 5 5 5 5 5 5 5 5 5 5 5 5 5 5 5 4 4
: 0 0 0 0 0 0 0 0 0 0 0 8 5 5 5 5 5 5 5 5 5 5 5 5 5 ; 0 0 0 0 0 0 0 0 0 0 0 0 0 0 0 0 0 0 0 0 0 0 0 0 0 0 0 7 4
: 0 0 0 0 0 0 0 0 0 0 0 0 0 0 0 0 0 0 0 0 0 0 0 0 0 0 0 0 0 0 0 0 0 2 0 0 0 2 0 0 0 2 0 0 0 2 0 0 0 0 0 0 0 7 4
: 0 0 0 0 1 0 H I H 0 0 H G 0 H 0 0 0 H 0 0 0 0 H 0 0 0 H 0 0 1 0 2 0 2 I 2 0 2 2 2 0 2 2 2 0 2 2 2 0 0 0 0 7 4
B ? 3 3 3 3 3 3 3 3 3 3 3 3 3 3 3 3 3 3 3 3 3 3 3 3 3 3 3 3 3 3 3 3 E 3 3 3 C 3 3 3 E 3 3 3 E 3 3 3 3 9 2 J 7 4
4 4 4 4 4 4 4 4 4 4 4 4 4 4 4 4 4 4 4 4 4 4 4 4 4 4 4 4 4 4 4 4 4 4 4 4 4 4 4 4 4 4 4 4 4 4 4 4 4 4 4 : 2 2 7 4
4 4 5 5 5 5 5 5 5 5 5 5 5 5 5 5 5 5 5 5 5 5 5 5 5 5 5 5 4 4 4 4 4 4 4 4 4 4 4 4 4 4 4 4 4 4 4 4 4 4 4 : 0 2 7 4
4 : 0 0 0 0 0 0 0 0 0 0 0 0 0 0 0 0 0 0 0 0 0 0 0 0 0 0 8 5 5 5 5 5 5 5 5 5 5 5 5 5 5 5 5 5 5 5 5 5 5 ; K 2 7 4
4 : 0 0 0 0 0 0 0 0 0 0 0 0 0 0 0 0 0 0 0 0 0 0 0 0 0 0 0 0 0 0 0 0 0 0 0 0 0 0 0 0 0 0 0 0 0 0 0 0 0 0 0 0 7 4
4 : 0 2 0 F 0 I 0 0 1 0 F H I H 0 0 F 0 0 0 H F 0 0 1 0 0 0 0 0 0 0 0 G 0 0 0 0 0 0 0 0 2 0 0 0 0 0 0 0 0 0 7 4
4 : K 2 6 3 3 3 3 3 3 3 3 3 3 3 3 3 3 3 3 3 3 3 3 3 3 9 0 I 0 0 0 0 2 0 2 0 I 0 0 0 2 2 0 I 0 G 6 3 9 0 H 0 7 4
4 : K 2 8 5 5 5 5 5 5 5 5 5 5 5 5 5 5 5 5 5 5 5 5 5 5 B ? 3 3 3 3 3 3 C 3 3 3 3 3 3 3 3 E 3 3 @ A 4 B ? 3 @ A 4
4 : 0 2 0 2 0 0 0 0 0 0 0 0 0 0 0 0 0 0 0 0 0 0 0 0 0 7 4 4 4 4 4 4 4 4 4 4 4 4 4 4 4 4 4 4 4 4 4 4 4 4 4 4 4 4
4 : 0 2 2 0 2 0 2 0 0 2 0 0 0 2 0 0 0 0 0 0 0 0 0 0 0 7 4 4 4 4 4 4 4 4 4 4 4 4 4 4 4 4 4 4 4 4 4 4 4 4 4 4 4 4
4 : I 2 0 F 0 2 0 2 2 0 2 2 2 0 2 2 0 0 I 0 0 0 0 0 0 7 4 4 4 4 4 4 4 4 4 4 4 4 4 4 4 4 4 4 4 4 4 4 4 4 4 4 4 4
4 B ? 3 3 3 3 3 E 3 3 C 3 3 3 C 3 3 3 3 3 3 3 3 9 2 J 8 5 5 5 5 5 5 5 5 5 5 5 5 5 5 5 5 5 5 5 5 5 5 4 4 4 4 4 4
4 4 4 4 4 4 4 4 4 4 4 4 4 4 4 4 4 4 4 4 4 4 4 4 : 2 0 0 0 0 0 0 0 0 0 0 0 0 0 0 0 0 2 0 0 2 0 0 0 0 7 4 4 4 4 4
4 4 4 4 4 4 4 4 4 4 4 4 4 4 4 4 4 4 4 4 4 4 4 4 : 2 0 0 0 0 0 0 0 0 0 0 2 0 0 2 0 2 0 2 2 0 2 0 0 0 7 4 4 4 4 4
4 4 4 4 4 4 4 4 4 4 4 4 4 4 4 4 4 4 4 4 4 4 4 4 : 2 2 2 2 0 0 0 I 0 0 2 0 2 2 0 2 0 F 0 0 F 0 0 0 0 7 4 4 4 4 4
4 4 4 4 4 4 4 4 4 4 4 4 4 4 4 4 4 4 4 4 4 4 4 4 B ? 3 3 3 3 3 3 3 3 3 3 E 3 3 C 3 3 3 3 3 3 3 9 0 J 7 4 4 4 4 4
4 4 4 4 4 4 4 4 4 4 4 4 4 4 5 5 5 5 5 5 5 5 5 5 5 5 5 5 5 5 5 5 5 5 5 5 5 5 5 5 5 5 5 5 5 5 5 ; 2 J 7 4 4 4 4 4
4 4 4 4 4 4 4 4 4 4 4 4 4 : 0 0 0 0 0 0 0 0 0 0 0 0 0 0 0 0 0 0 0 0 0 0 0 0 0 0 0 0 0 0 0 0 0 0 2 0 7 4 4 4 4 4
4 4 4 4 4 4 4 4 4 4 4 4 4 : 0 0 G 0 1 2 2 2 H 2 2 2 H 2 2 2 2 H 2 2 2 2 H 0 G 0 0 0 H 1 2 2 2 2 2 0 7 4 4 4 4 4
4 4 4 4 4 4 4 4 4 4 4 4 4 : K 2 6 3 3 3 3 3 3 3 3 3 3 3 3 3 3 3 3 3 3 3 3 3 3 3 3 3 3 3 3 3 3 3 3 @ A 4 4 4 4 4
4 4 4 4 4 4 4 4 4 4 4 4 4 : 0 2 0 0 0 0 0 0 0 0 0 0 0 0 0 0 0 0 0 0 0 0 0 0 0 0 0 0 0 0 0 0 0 0 0 0 0 0 0 0 0 1
4 4 4 4 4 4 4 4 4 4 4 4 4 : 0 2 1 0 H 0 0 0 0 H 0 0 0 0 0 0 H 0 0 0 0 H 0 0 0 0 H 0 0 0 0 1 0 0 G 0 0 0 0 0 0 1
4 4 4 4 4 4 4 4 4 4 4 4 4 B ? 3 3 3 3 3 3 3 3 3 3 3 3 3 3 3 3 3 3 3 3 3 3 3 3 3 3 3 3 3 3 3 3 3 3 3 3 3 3 3 3 3